#,#,#,#,#,#,#,#,#,#,#,#,#,#,#,#,#,#,#,#,#,#,#,#,#,#,#,#,#,#,#,#,#,#,#,#,#,#,#,#,#,#,#,#,#,#,#,#,#,#,#,#,#,#,#,#,#,#,#,#,#,#,#,#,#,#,#,#,#,#,#,#,#,#,#,#,#,#,#,#,#,#
#,,@,@,@,W,@,@,@,@,@,W,@,@,@,W,@,@,@,,,,,,,,,,,,,,@,@,@,W,@,W,@,@,@,@,@,W,@,W,@,@,@,,,,,,,,,,,,,,,,,,,,,,,,,,,,,,,,,#
#,,@,S,C,H,@,,M,E,@,E,M,,@,H,C,S,@,,,,,,,,,,,,,,W,E,M,,@,H,C,S,@,S,C,H,@,,M,E,@,,,,,,,,,,,,,,,,,,,,,,,,,,,,,,,,,#
#,,@,,,,D,,,,@,,,,D,,,,@,,,,,,,,,,,,,,@,,,,D,,,,@,,,,D,,,,@,,,,,,,,,,,,,,,,,,,,,,,,,,,,,,,,,#
#,,@,@,@,@,@,,@,@,@,@,@,,@,@,@,@,@,,,,,,,,,,@,@,@,@,@,@,@,,@,@,@,@,@,@,@,@,@,,@,@,@,,,,,,,,,,,,,,,,,,,,,,,,,,,,,,,,,#
#,,@,H,B,@,L,,,N,@,N,,,L,@,B,H,@,,,,,,,,,,@,C,C,H,@,N,,,L,@,B,H,@,H,B,@,L,,,N,W,,,,,,,,,,,,,,,,,,,,,,,,,,,,,,,,,#
#,,@,,,D,,,,A,@,A,,,,D,,,@,,,,,,,,,,@,,,,@,A,,,,D,,,@,,,D,,,,A,@,,,,,,,,,,,,,,,,,,,,,,,,,,,,,,,,,#
#,,@,C,T,@,,,,N,@,N,,,,@,T,C,@,,,,,,,,,,@,,,,@,N,,,,@,T,C,@,C,T,@,,,,N,@,,,,,,,,,,,,,,,,,,,,,,,,,,,,,,,,,#
#,,@,W,@,@,@,D,@,@,@,@,@,D,@,@,@,@,@,,,,,,,,,,@,D,@,@,@,@,@,D,@,@,@,@,@,@,@,@,@,D,@,@,@,,,,,,,,,,,,,,,,,,,,,,,,,,,,,,,,,#
#,,,,,,,,,,,,,,,,,,,,,,,,,,,,@,,,,,,,,,,,,,,,,,,,PLANT1,@,,,,,,,,,,,,,,,,,,,,,,,,,,,,,,,,,#
#,,,,,,,,,,,,,,,,,,,,,,,,,,,,W,,,,,,,,,,,,,,,,,,,,W,,,,,,,,,,,,,,,,,,,,,,,,,,,,,,,,,#
#,,,,,,,,,,,,,,,,,,,,,,,,,,,,@,,,,,,,,,,,,,,,,,,,PLANT1,@,,,,,,,,,,,,,,,,,,,,,,,,,,,,,,,,,#
#,,,,,,,,,,,,,,,,,,,,,,,,,,,,@,ST,ST,ST,@,@,@,D,@,@,@,@,@,@,@,@,@,D,@,@,@,,,,,,,,,,,,,,,,,,,,,,,,,,,,,,,,,#
#,,,,,,,,,,,,,,,,,,,,,,,,,,,,@,+,+,+,@,N,,,,@,T,C,@,C,T,@,,,,N,@,,,,,,,,,,,,,,,,,,,,,,,,,,,,,,,,,#
#,,@,@,@,@,@,@,@,@,@,@,D,@,@,@,@,@,@,,,,,,,,,,@,+,+,+,@,A,,,,D,,,@,,,D,,,,A,@,,,,,,,,,,,,,,,,,,,,,,,,,,,,,,,,,#
#,,@,,,,,,,,D,,,,,,,,@,,,,,,,,,,@,+,+,+,@,N,,,L,@,B,,@,,B,@,L,,,N,W,,,,,,,,,,,,,,,,,,,,,,,,,,,,,,,,,#
#,,W,,,,,,,,@,,,,,,,,@,,,,,,,,,,@,+,+,+,@,@,@,,@,@,@,@,@,@,@,@,@,,@,@,@,,,,,,,,,,,,,,,,,,,,,,,,,,,,,,,,,#
#,,@,,,,,,,,@,@,@,@,@,@,@,@,@,,,,,,,,,,@,+,+,+,@,,,,D,,,,@,,,,D,,,,@,,,,,,,,,,,,,,,,,,,,,,,,,,,,,,,,,#
#,,@,,,,,,,,,,,,,,,,@,,,,,,,,,,@,+,+,+,@,E,M,,@,H,C,S,@,S,C,H,@,,M,E,@,,,,,,,,,,,,,,,,,,,,,,,,,,,,,,,,,#
#,,W,,,,,,,,,,,,,,,,W,,,,,,,,,,@,+,+,+,@,@,@,@,@,@,@,@,@,@,@,@,@,@,@,@,@,,,,,,,,,,,,,,,,,,,,,,,,,,,,,,,,,#
#,,@,,,,,,,,,,,,,,,,@,,,,,,,,,,@,+,+,+,@,E,M,,@,H,C,S,@,S,C,H,@,,M,E,@,,,,,,,,,,,,,,,,,,,,,,,,,,,,,,,,,#
#,,@,@,@,@,@,@,@,@,@,@,@,D,@,@,W,@,@,,,,,,,,,,@,+,+,+,@,,,,D,,,,@,,,,D,,,,@,,,,,,,,,,,,,,,,,,,,,,,,,,,,,,,,,#
#,,,,,,,,,,,,,,,,,,,,,,,,,,,,@,+,+,+,@,@,@,,@,@,@,@,@,@,@,@,@,,@,@,@,,,,,,,,,,,,,,,,,,,,,,,,,,,,,,,,,#
#,,,,,,,,,,,,,,,,,,,,,,,,,,,,@,+,+,+,@,N,,,L,@,B,H,@,H,B,@,L,,,N,W,,,,,,,,,,,,,,,,,,,,,,,,,,,,,,,,,#
#,,,,,,,,,,,,,,,,,,,,,,,,,,,,@,+,+,+,@,A,,,,D,,,@,,,D,,,,A,@,,,,,,,,,,,,,,,,,,,,,,,,,,,,,,,,,#
#,,,,,,,,,,,,,,,,,,,,,,,,,,,,@,+,+,+,@,N,,,,@,T,C,@,C,T,@,,,,N,@,,,,,,,,,,,,,,,,,,,,,,,,,,,,,,,,,#
#,,,,,,,,,,,,,,,,,,,,,,,,,,,,@,ST,ST,ST,@,@,@,D,@,@,@,@,@,@,@,@,@,D,@,@,@,,,,,,,,,,,,,,,,,,,,,,,,,,,,,,,,,#
#,,@,@,@,@,@,@,@,@,@,@,@,@,@,@,@,@,@,,,,,,,,,,@,,,,,,,,,,,,,,,,,,,PLANT1,@,,,,,,,,,,,,,,,,,,,,,,,,,,,,,,,,,#
#,,@,,,,,,,,@,E,M,,@,H,C,S,@,,,,,,,,,,W,,,,,,,,,,,,,,,,,,,,W,,,,,,,,,,,,,,,,,,,,,,,,,,,,,,,,,#
#,,@,,,,,,,,@,,,,D,,,,@,,,,,,,,,,@,,,,,,,,,,,,,,,,,,,PLANT1,@,,,,,,,,,,,,,,,,,,,,,,,,,,,,,,,,,#
#,,@,@,@,@,@,@,,@,@,@,@,,@,@,@,@,@,,,,,,,,,,@,@,D,@,@,@,@,@,@,@,@,@,@,@,@,@,@,@,@,@,@,,,,,,,,,,,,,,,,,,,,,,,,,,,,,,,,,#
#,,@,,,,,,,,@,N,,,L,@,B,H,@,,,,,,,,,,@,,,,,,,,,,,,,,,,,,,,@,,,,,,,,,,,,,,,,,,,,,,,,,,,,,,,,,#
#,,W,,,,,,,,@,A,,,,D,,,@,,,,,,,,,,@,,,,,,,,,,,,,,,,,,,,@,,,,,,,,,,,,,,,,,,,,,,,,,,,,,,,,,#
#,,@,,,,,,,,@,N,,,,@,T,C,@,,,,,,,,,,@,,,,,,,,,,,,,,,,,,,,@,,,,,,,,,,,,,,,,,,,,,,,,,,,,,,,,,#
#,,@,@,@,D,@,@,W,@,@,@,@,D,@,@,@,@,@,,,,,,,,,,@,@,@,@,W,@,@,W,@,@,W,@,@,W,@,@,D,@,W,@,@,,,,,,,,,,,,,,,,,,,,,,,,,,,,,,,,,#
#,,,,,,,,,,,,,,,,,,,,,,,,,,,,,,,,,,,,,,,,,,,,,,,,,,,,,,,,,,,,,,,,,,,,,,,,,,,,,,,,,#
#,,,,,,,,,,,,,,,,,,,,,,,,,,,,,,,,,,,,,,,,,,,,,,,,,,,,,,,,,,,,,,,,,,,,,,,,,,,,,,,,,#
#,,,,,,,,,,,,,,,,,,,,,,,,,,,,,,,,,,,,,,,,,,,,,,,,,,,,,,,,,,,,,,,,,,,,,,,,,,,,,,,,,#
#,,,,,,,,,,,,,,,,,,,,,,,,,,,,,,,,,,,,,,,,,,,,,,,,,,,,,,,,,,,,,,,,,,,,,,,,,,,,,,,,,#
#,,,,,,,,,,,,,,,,,,,,,,,,,,,,,,,,,,,,,,,,,,,,,,,,,,,,,,,,,,,,,,,,,,,,,,,,,,,,,,,,,#
#,,,,,,,,,,,,,,,,,,,,,,,,,,,,,,,,,,,,,,,,,,,,,,,,,,,,,,,,,,,,,,,,,,,,,,,,,,,,,,,,,#
#,,,,,,,,,,,,,,,,,,,,,,,,,,,,,,,,,,,,,,,,,,,,,,,,,,,,,,,,,,,,,,,,,,,,,,,,,,,,,,,,,#
#,,,,,,,,,,,,,,,,,,,,,,,,,,,,,,,,,,,,,,,,,,,,,,,,,,,,,,,,,,,,,,,,,,,,,,,,,,,,,,,,,#
#,,,,,,,,,,,,,,,,,,,,,,,,,,,,,,,,,,,,,,,,,,,,,,,,,,,,,,,,,,,,,,,,,,,,,,,,,,,,,,,,,#
#,#,#,#,#,#,#,#,#,#,#,#,#,#,#,#,#,#,#,#,#,#,#,#,#,#,#,#,#,#,#,#,#,#,#,#,#,#,#,#,#,#,#,#,#,#,#,#,#,#,#,#,#,#,#,#,#,#,#,#,#,#,#,#,#,#,#,#,#,#,#,#,#,#,#,#,#,#,#,#,#,#
